Week Starting,Category,Item,Starting Inventory,Quantity Sold (Weekly Total),Ending Inventory
2/26/2024,Cold Drinks,Coca-Cola Pocket Pack,34,29,5
2/26/2024,Cold Drinks,Mountain Dew Pocket Pack,46,39,7
2/26/2024,Cold Drinks,Sprite Pocket Pack,26,22,4
2/26/2024,Dehydrated Fruits,Blueberries,3,3,0
2/26/2024,Dehydrated Fruits,Cranberries,3,3,0
2/26/2024,Dehydrated Fruits,Dried Mango,3,3,0
2/26/2024,Dehydrated Fruits,Dry Cherries,3,3,0
2/26/2024,Dehydrated Fruits,Kiwi,3,3,0
2/26/2024,Dehydrated Fruits,Pineapple Coin,3,3,0
2/26/2024,Dehydrated Fruits,Prunes,3,3,0
2/26/2024,Dehydrated Fruits,Strawberries,3,3,0
2/26/2024,Dry Fruits,Almonds California,3,2,1
2/26/2024,Dry Fruits,Black Kismis,2,2,0
2/26/2024,Dry Fruits,Brazil Nuts,2,2,0
2/26/2024,Dry Fruits,Cashew,3,2,1
2/26/2024,Dry Fruits,Dry Dates Yellow,2,2,0
2/26/2024,Dry Fruits,Hazelnuts,2,2,0
2/26/2024,Dry Fruits,Pecan Nuts,2,2,0
2/26/2024,Dry Fruits,Plain Pista,2,2,0
2/26/2024,Dry Fruits,Salted Pista,2,2,0
2/26/2024,Dry Fruits,Walnut,2,2,0
2/26/2024,Groceries,Bajra flour,21,18,3
2/26/2024,Groceries,Chana Dal (Sanaga pappu),3,3,0
2/26/2024,Groceries,Idly Rawa (Sri Lalitha),30,25,5
2/26/2024,Groceries,Masoor Dal,10,9,1
2/26/2024,Groceries,Moong Dal (Pesara pappu),6,5,1
2/26/2024,Groceries,Peanuts (Palli),7,6,1
2/26/2024,Groceries,Rice Rawa,10,9,1
2/26/2024,Groceries,Toor Dal (Kandipappu),6,5,1
2/26/2024,Groceries,Urad Dal (Minapappu),7,6,1
2/26/2024,Groceries,Wheat Flour (Aashirvad),14,12,2
2/26/2024,Oils,Freedom Sunflower Oil,3,3,0
2/26/2024,Oils,Gold Drop Sunflower Oil,3,3,0
2/26/2024,Oils,Rajini Palm Oil,4,4,0
2/26/2024,Oils,Vijaya Groundnut Oil,3,3,0
2/26/2024,Seeds,Basil (Sabja) Seeds,2,2,0
2/26/2024,Seeds,Chia Seeds,2,2,0
2/26/2024,Seeds,Flax Seeds,2,2,0
2/26/2024,Seeds,Kalonji Seeds,2,2,0
2/26/2024,Seeds,Mahabeera Seeds,2,2,0
2/26/2024,Seeds,Pumpkin Seeds,2,2,0
2/26/2024,Seeds,Sunflower Seeds,2,2,0
2/26/2024,Seeds,Watermelon Seeds,2,2,0
2/26/2024,Snacks,Biscuits,148,114,34
2/26/2024,Snacks,Chips,150,116,34
2/26/2024,Snacks,Chocolates,153,118,35
2/26/2024,Snacks,Namkeen,172,133,39
2/26/2024,Snacks,Popcorn,159,123,36
2/26/2024,Spices,Cinnamon Premium,3,3,0
2/26/2024,Spices,Clove,3,3,0
2/26/2024,Spices,Coriander Seeds (Dhaniyalu),7,6,1
2/26/2024,Spices,Elachi (8 MM),3,3,0
2/26/2024,Spices,Jaji Kaya,3,3,0
2/26/2024,Spices,Khus Khus (GASALU),3,3,0
2/26/2024,Spices,Leaf Leaf (Biryani Leaf),3,3,0
2/26/2024,Spices,Mustard Seeds (aavalu),3,3,0
2/26/2024,Spices,Pepper (Miriyalu),3,3,0
3/4/2024,Cold Drinks,Coca-Cola Pocket Pack,69,58,11
3/4/2024,Cold Drinks,Mountain Dew Pocket Pack,110,92,18
3/4/2024,Cold Drinks,Sprite Pocket Pack,78,65,13
3/4/2024,Dehydrated Fruits,Blueberries,8,7,1
3/4/2024,Dehydrated Fruits,Cranberries,8,7,1
3/4/2024,Dehydrated Fruits,Dried Mango,8,7,1
3/4/2024,Dehydrated Fruits,Dry Cherries,8,7,1
3/4/2024,Dehydrated Fruits,Kiwi,8,7,1
3/4/2024,Dehydrated Fruits,Pineapple Coin,8,7,1
3/4/2024,Dehydrated Fruits,Prunes,8,7,1
3/4/2024,Dehydrated Fruits,Strawberries,8,7,1
3/4/2024,Dry Fruits,Almonds California,6,4,2
3/4/2024,Dry Fruits,Black Kismis,4,4,0
3/4/2024,Dry Fruits,Brazil Nuts,4,4,0
3/4/2024,Dry Fruits,Cashew,6,4,2
3/4/2024,Dry Fruits,Dry Dates Yellow,4,4,0
3/4/2024,Dry Fruits,Hazelnuts,4,4,0
3/4/2024,Dry Fruits,Pecan Nuts,4,4,0
3/4/2024,Dry Fruits,Plain Pista,4,4,0
3/4/2024,Dry Fruits,Salted Pista,4,4,0
3/4/2024,Dry Fruits,Walnut,4,4,0
3/4/2024,Groceries,Bajra flour,38,32,6
3/4/2024,Groceries,Chana Dal (Sanaga pappu),15,13,2
3/4/2024,Groceries,Idly Rawa (Sri Lalitha),51,43,8
3/4/2024,Groceries,Masoor Dal,22,19,3
3/4/2024,Groceries,Moong Dal (Pesara pappu),15,13,2
3/4/2024,Groceries,Peanuts (Palli),13,11,2
3/4/2024,Groceries,Rice Rawa,36,30,6
3/4/2024,Groceries,Toor Dal (Kandipappu),10,9,1
3/4/2024,Groceries,Urad Dal (Minapappu),12,10,2
3/4/2024,Groceries,Wheat Flour (Aashirvad),30,25,5
3/4/2024,Oils,Freedom Sunflower Oil,9,8,1
3/4/2024,Oils,Gold Drop Sunflower Oil,8,7,1
3/4/2024,Oils,Rajini Palm Oil,8,7,1
3/4/2024,Oils,Vijaya Groundnut Oil,8,7,1
3/4/2024,Seeds,Basil (Sabja) Seeds,7,6,1
3/4/2024,Seeds,Chia Seeds,7,6,1
3/4/2024,Seeds,Flax Seeds,7,6,1
3/4/2024,Seeds,Kalonji Seeds,7,6,1
3/4/2024,Seeds,Mahabeera Seeds,7,6,1
3/4/2024,Seeds,Pumpkin Seeds,7,6,1
3/4/2024,Seeds,Sunflower Seeds,7,6,1
3/4/2024,Seeds,Watermelon Seeds,7,6,1
3/4/2024,Snacks,Biscuits,306,236,70
3/4/2024,Snacks,Chips,328,253,75
3/4/2024,Snacks,Chocolates,364,280,84
3/4/2024,Snacks,Namkeen,332,256,76
3/4/2024,Snacks,Popcorn,256,197,59
3/4/2024,Spices,Cinnamon Premium,8,7,1
3/4/2024,Spices,Clove,8,7,1
3/4/2024,Spices,Coriander Seeds (Dhaniyalu),12,10,2
3/4/2024,Spices,Elachi (8 MM),8,7,1
3/4/2024,Spices,Jaji Kaya,8,7,1
3/4/2024,Spices,Khus Khus (GASALU),8,7,1
3/4/2024,Spices,Leaf Leaf (Biryani Leaf),8,7,1
3/4/2024,Spices,Mustard Seeds (aavalu),9,8,1
3/4/2024,Spices,Pepper (Miriyalu),8,7,1
3/11/2024,Cold Drinks,Coca-Cola Pocket Pack,86,72,14
3/11/2024,Cold Drinks,Mountain Dew Pocket Pack,70,59,11
3/11/2024,Cold Drinks,Sprite Pocket Pack,93,78,15
3/11/2024,Dehydrated Fruits,Blueberries,8,7,1
3/11/2024,Dehydrated Fruits,Cranberries,8,7,1
3/11/2024,Dehydrated Fruits,Dried Mango,8,7,1
3/11/2024,Dehydrated Fruits,Dry Cherries,8,7,1
3/11/2024,Dehydrated Fruits,Kiwi,8,7,1
3/11/2024,Dehydrated Fruits,Pineapple Coin,8,7,1
3/11/2024,Dehydrated Fruits,Prunes,8,7,1
3/11/2024,Dehydrated Fruits,Strawberries,8,7,1
3/11/2024,Dry Fruits,Almonds California,7,5,2
3/11/2024,Dry Fruits,Black Kismis,6,5,1
3/11/2024,Dry Fruits,Brazil Nuts,6,5,1
3/11/2024,Dry Fruits,Cashew,7,5,2
3/11/2024,Dry Fruits,Dry Dates Yellow,6,5,1
3/11/2024,Dry Fruits,Hazelnuts,6,5,1
3/11/2024,Dry Fruits,Pecan Nuts,6,5,1
3/11/2024,Dry Fruits,Plain Pista,6,5,1
3/11/2024,Dry Fruits,Salted Pista,6,5,1
3/11/2024,Dry Fruits,Walnut,6,5,1
3/11/2024,Groceries,Bajra flour,52,44,8
3/11/2024,Groceries,Chana Dal (Sanaga pappu),26,22,4
3/11/2024,Groceries,Idly Rawa (Sri Lalitha),42,35,7
3/11/2024,Groceries,Masoor Dal,21,18,3
3/11/2024,Groceries,Moong Dal (Pesara pappu),13,11,2
3/11/2024,Groceries,Peanuts (Palli),13,11,2
3/11/2024,Groceries,Rice Rawa,28,24,4
3/11/2024,Groceries,Toor Dal (Kandipappu),12,10,2
3/11/2024,Groceries,Urad Dal (Minapappu),9,8,1
3/11/2024,Groceries,Wheat Flour (Aashirvad),44,37,7
3/11/2024,Oils,Freedom Sunflower Oil,8,7,1
3/11/2024,Oils,Gold Drop Sunflower Oil,8,7,1
3/11/2024,Oils,Rajini Palm Oil,9,8,1
3/11/2024,Oils,Vijaya Groundnut Oil,8,7,1
3/11/2024,Seeds,Basil (Sabja) Seeds,4,4,0
3/11/2024,Seeds,Chia Seeds,4,4,0
3/11/2024,Seeds,Flax Seeds,4,4,0
3/11/2024,Seeds,Kalonji Seeds,4,4,0
3/11/2024,Seeds,Mahabeera Seeds,4,4,0
3/11/2024,Seeds,Pumpkin Seeds,4,4,0
3/11/2024,Seeds,Sunflower Seeds,4,4,0
3/11/2024,Seeds,Watermelon Seeds,4,4,0
3/11/2024,Snacks,Biscuits,314,242,72
3/11/2024,Snacks,Chips,306,236,70
3/11/2024,Snacks,Chocolates,323,249,74
3/11/2024,Snacks,Namkeen,313,241,72
3/11/2024,Snacks,Popcorn,301,232,69
3/11/2024,Spices,Cinnamon Premium,8,7,1
3/11/2024,Spices,Clove,8,7,1
3/11/2024,Spices,Coriander Seeds (Dhaniyalu),13,11,2
3/11/2024,Spices,Elachi (8 MM),8,7,1
3/11/2024,Spices,Jaji Kaya,8,7,1
3/11/2024,Spices,Khus Khus (GASALU),8,7,1
3/11/2024,Spices,Leaf Leaf (Biryani Leaf),8,7,1
3/11/2024,Spices,Mustard Seeds (aavalu),9,8,1
3/11/2024,Spices,Pepper (Miriyalu),8,7,1
3/18/2024,Cold Drinks,Coca-Cola Pocket Pack,80,67,13
3/18/2024,Cold Drinks,Mountain Dew Pocket Pack,98,82,16
3/18/2024,Cold Drinks,Sprite Pocket Pack,78,65,13
3/18/2024,Dehydrated Fruits,Blueberries,8,7,1
3/18/2024,Dehydrated Fruits,Cranberries,8,7,1
3/18/2024,Dehydrated Fruits,Dried Mango,8,7,1
3/18/2024,Dehydrated Fruits,Dry Cherries,8,7,1
3/18/2024,Dehydrated Fruits,Kiwi,8,7,1
3/18/2024,Dehydrated Fruits,Pineapple Coin,8,7,1
3/18/2024,Dehydrated Fruits,Prunes,8,7,1
3/18/2024,Dehydrated Fruits,Strawberries,8,7,1
3/18/2024,Dry Fruits,Almonds California,6,4,2
3/18/2024,Dry Fruits,Black Kismis,4,4,0
3/18/2024,Dry Fruits,Brazil Nuts,4,4,0
3/18/2024,Dry Fruits,Cashew,6,4,2
3/18/2024,Dry Fruits,Dry Dates Yellow,4,4,0
3/18/2024,Dry Fruits,Hazelnuts,4,4,0
3/18/2024,Dry Fruits,Pecan Nuts,4,4,0
3/18/2024,Dry Fruits,Plain Pista,4,4,0
3/18/2024,Dry Fruits,Salted Pista,4,4,0
3/18/2024,Dry Fruits,Walnut,4,4,0
3/18/2024,Groceries,Bajra flour,42,35,7
3/18/2024,Groceries,Chana Dal (Sanaga pappu),21,18,3
3/18/2024,Groceries,Idly Rawa (Sri Lalitha),42,35,7
3/18/2024,Groceries,Masoor Dal,32,27,5
3/18/2024,Groceries,Moong Dal (Pesara pappu),14,12,2
3/18/2024,Groceries,Peanuts (Palli),10,9,1
3/18/2024,Groceries,Rice Rawa,26,22,4
3/18/2024,Groceries,Toor Dal (Kandipappu),13,11,2
3/18/2024,Groceries,Urad Dal (Minapappu),10,9,1
3/18/2024,Groceries,Wheat Flour (Aashirvad),44,37,7
3/18/2024,Oils,Freedom Sunflower Oil,8,7,1
3/18/2024,Oils,Gold Drop Sunflower Oil,9,8,1
3/18/2024,Oils,Rajini Palm Oil,9,8,1
3/18/2024,Oils,Vijaya Groundnut Oil,8,7,1
3/18/2024,Seeds,Basil (Sabja) Seeds,4,4,0
3/18/2024,Seeds,Chia Seeds,4,4,0
3/18/2024,Seeds,Flax Seeds,4,4,0
3/18/2024,Seeds,Kalonji Seeds,4,4,0
3/18/2024,Seeds,Mahabeera Seeds,4,4,0
3/18/2024,Seeds,Pumpkin Seeds,4,4,0
3/18/2024,Seeds,Sunflower Seeds,4,4,0
3/18/2024,Seeds,Watermelon Seeds,4,4,0
3/18/2024,Snacks,Biscuits,323,249,74
3/18/2024,Snacks,Chips,297,229,68
3/18/2024,Snacks,Chocolates,315,243,72
3/18/2024,Snacks,Namkeen,338,260,78
3/18/2024,Snacks,Popcorn,326,251,75
3/18/2024,Spices,Cinnamon Premium,8,7,1
3/18/2024,Spices,Clove,8,7,1
3/18/2024,Spices,Coriander Seeds (Dhaniyalu),10,9,1
3/18/2024,Spices,Elachi (8 MM),8,7,1
3/18/2024,Spices,Jaji Kaya,8,7,1
3/18/2024,Spices,Khus Khus (GASALU),8,7,1
3/18/2024,Spices,Leaf Leaf (Biryani Leaf),9,8,1
3/18/2024,Spices,Mustard Seeds (aavalu),8,7,1
3/18/2024,Spices,Pepper (Miriyalu),8,7,1
3/25/2024,Cold Drinks,Coca-Cola Pocket Pack,70,59,11
3/25/2024,Cold Drinks,Mountain Dew Pocket Pack,115,96,19
3/25/2024,Cold Drinks,Sprite Pocket Pack,70,59,11
3/25/2024,Dehydrated Fruits,Blueberries,8,7,1
3/25/2024,Dehydrated Fruits,Cranberries,8,7,1
3/25/2024,Dehydrated Fruits,Dried Mango,8,7,1
3/25/2024,Dehydrated Fruits,Dry Cherries,8,7,1
3/25/2024,Dehydrated Fruits,Kiwi,8,7,1
3/25/2024,Dehydrated Fruits,Pineapple Coin,8,7,1
3/25/2024,Dehydrated Fruits,Prunes,8,7,1
3/25/2024,Dehydrated Fruits,Strawberries,8,7,1
3/25/2024,Dry Fruits,Almonds California,6,4,2
3/25/2024,Dry Fruits,Black Kismis,4,4,0
3/25/2024,Dry Fruits,Brazil Nuts,4,4,0
3/25/2024,Dry Fruits,Cashew,6,4,2
3/25/2024,Dry Fruits,Dry Dates Yellow,4,4,0
3/25/2024,Dry Fruits,Hazelnuts,4,4,0
3/25/2024,Dry Fruits,Pecan Nuts,4,4,0
3/25/2024,Dry Fruits,Plain Pista,4,4,0
3/25/2024,Dry Fruits,Salted Pista,4,4,0
3/25/2024,Dry Fruits,Walnut,4,4,0
3/25/2024,Groceries,Bajra flour,37,31,6
3/25/2024,Groceries,Chana Dal (Sanaga pappu),14,12,2
3/25/2024,Groceries,Idly Rawa (Sri Lalitha),43,36,7
3/25/2024,Groceries,Masoor Dal,31,26,5
3/25/2024,Groceries,Moong Dal (Pesara pappu),9,8,1
3/25/2024,Groceries,Peanuts (Palli),12,10,2
3/25/2024,Groceries,Rice Rawa,43,36,7
3/25/2024,Groceries,Toor Dal (Kandipappu),9,8,1
3/25/2024,Groceries,Urad Dal (Minapappu),10,9,1
3/25/2024,Groceries,Wheat Flour (Aashirvad),39,33,6
3/25/2024,Oils,Freedom Sunflower Oil,8,7,1
3/25/2024,Oils,Gold Drop Sunflower Oil,8,7,1
3/25/2024,Oils,Rajini Palm Oil,10,9,1
3/25/2024,Oils,Vijaya Groundnut Oil,8,7,1
3/25/2024,Seeds,Basil (Sabja) Seeds,3,3,0
3/25/2024,Seeds,Chia Seeds,3,3,0
3/25/2024,Seeds,Flax Seeds,3,3,0
3/25/2024,Seeds,Kalonji Seeds,3,3,0
3/25/2024,Seeds,Mahabeera Seeds,3,3,0
3/25/2024,Seeds,Pumpkin Seeds,3,3,0
3/25/2024,Seeds,Sunflower Seeds,3,3,0
3/25/2024,Seeds,Watermelon Seeds,3,3,0
3/25/2024,Snacks,Biscuits,293,226,67
3/25/2024,Snacks,Chips,335,258,77
3/25/2024,Snacks,Chocolates,315,243,72
3/25/2024,Snacks,Namkeen,326,251,75
3/25/2024,Snacks,Popcorn,284,219,65
3/25/2024,Spices,Cinnamon Premium,8,7,1
3/25/2024,Spices,Clove,8,7,1
3/25/2024,Spices,Coriander Seeds (Dhaniyalu),12,10,2
3/25/2024,Spices,Elachi (8 MM),8,7,1
3/25/2024,Spices,Jaji Kaya,8,7,1
3/25/2024,Spices,Khus Khus (GASALU),8,7,1
3/25/2024,Spices,Leaf Leaf (Biryani Leaf),8,7,1
3/25/2024,Spices,Mustard Seeds (aavalu),9,8,1
3/25/2024,Spices,Pepper (Miriyalu),8,7,1
4/1/2024,Cold Drinks,Coca-Cola Pocket Pack,80,67,13
4/1/2024,Cold Drinks,Mountain Dew Pocket Pack,78,65,13
4/1/2024,Cold Drinks,Sprite Pocket Pack,85,71,14
4/1/2024,Dehydrated Fruits,Blueberries,8,7,1
4/1/2024,Dehydrated Fruits,Cranberries,8,7,1
4/1/2024,Dehydrated Fruits,Dried Mango,8,7,1
4/1/2024,Dehydrated Fruits,Dry Cherries,8,7,1
4/1/2024,Dehydrated Fruits,Kiwi,8,7,1
4/1/2024,Dehydrated Fruits,Pineapple Coin,8,7,1
4/1/2024,Dehydrated Fruits,Prunes,8,7,1
4/1/2024,Dehydrated Fruits,Strawberries,8,7,1
4/1/2024,Dry Fruits,Almonds California,7,5,2
4/1/2024,Dry Fruits,Black Kismis,6,5,1
4/1/2024,Dry Fruits,Brazil Nuts,6,5,1
4/1/2024,Dry Fruits,Cashew,7,5,2
4/1/2024,Dry Fruits,Dry Dates Yellow,6,5,1
4/1/2024,Dry Fruits,Hazelnuts,6,5,1
4/1/2024,Dry Fruits,Pecan Nuts,6,5,1
4/1/2024,Dry Fruits,Plain Pista,6,5,1
4/1/2024,Dry Fruits,Salted Pista,6,5,1
4/1/2024,Dry Fruits,Walnut,6,5,1
4/1/2024,Groceries,Bajra flour,44,37,7
4/1/2024,Groceries,Chana Dal (Sanaga pappu),22,19,3
4/1/2024,Groceries,Idly Rawa (Sri Lalitha),44,37,7
4/1/2024,Groceries,Masoor Dal,20,17,3
4/1/2024,Groceries,Moong Dal (Pesara pappu),13,11,2
4/1/2024,Groceries,Peanuts (Palli),13,11,2
4/1/2024,Groceries,Rice Rawa,37,31,6
4/1/2024,Groceries,Toor Dal (Kandipappu),9,8,1
4/1/2024,Groceries,Urad Dal (Minapappu),13,11,2
4/1/2024,Groceries,Wheat Flour (Aashirvad),36,30,6
4/1/2024,Oils,Freedom Sunflower Oil,8,7,1
4/1/2024,Oils,Gold Drop Sunflower Oil,9,8,1
4/1/2024,Oils,Rajini Palm Oil,8,7,1
4/1/2024,Oils,Vijaya Groundnut Oil,8,7,1
4/1/2024,Seeds,Basil (Sabja) Seeds,3,3,0
4/1/2024,Seeds,Chia Seeds,3,3,0
4/1/2024,Seeds,Flax Seeds,3,3,0
4/1/2024,Seeds,Kalonji Seeds,3,3,0
4/1/2024,Seeds,Mahabeera Seeds,3,3,0
4/1/2024,Seeds,Pumpkin Seeds,3,3,0
4/1/2024,Seeds,Sunflower Seeds,3,3,0
4/1/2024,Seeds,Watermelon Seeds,3,3,0
4/1/2024,Snacks,Biscuits,339,261,78
4/1/2024,Snacks,Chips,338,260,78
4/1/2024,Snacks,Chocolates,253,195,58
4/1/2024,Snacks,Namkeen,276,213,63
4/1/2024,Snacks,Popcorn,349,269,80
4/1/2024,Spices,Cinnamon Premium,8,7,1
4/1/2024,Spices,Clove,8,7,1
4/1/2024,Spices,Coriander Seeds (Dhaniyalu),10,9,1
4/1/2024,Spices,Elachi (8 MM),8,7,1
4/1/2024,Spices,Jaji Kaya,8,7,1
4/1/2024,Spices,Khus Khus (GASALU),8,7,1
4/1/2024,Spices,Leaf Leaf (Biryani Leaf),8,7,1
4/1/2024,Spices,Mustard Seeds (aavalu),8,7,1
4/1/2024,Spices,Pepper (Miriyalu),8,7,1
4/8/2024,Cold Drinks,Coca-Cola Pocket Pack,93,78,15
4/8/2024,Cold Drinks,Mountain Dew Pocket Pack,75,63,12
4/8/2024,Cold Drinks,Sprite Pocket Pack,92,77,15
4/8/2024,Dehydrated Fruits,Blueberries,8,7,1
4/8/2024,Dehydrated Fruits,Cranberries,8,7,1
4/8/2024,Dehydrated Fruits,Dried Mango,8,7,1
4/8/2024,Dehydrated Fruits,Dry Cherries,8,7,1
4/8/2024,Dehydrated Fruits,Kiwi,8,7,1
4/8/2024,Dehydrated Fruits,Pineapple Coin,8,7,1
4/8/2024,Dehydrated Fruits,Prunes,8,7,1
4/8/2024,Dehydrated Fruits,Strawberries,8,7,1
4/8/2024,Dry Fruits,Almonds California,4,3,1
4/8/2024,Dry Fruits,Black Kismis,3,3,0
4/8/2024,Dry Fruits,Brazil Nuts,3,3,0
4/8/2024,Dry Fruits,Cashew,4,3,1
4/8/2024,Dry Fruits,Dry Dates Yellow,3,3,0
4/8/2024,Dry Fruits,Hazelnuts,3,3,0
4/8/2024,Dry Fruits,Pecan Nuts,3,3,0
4/8/2024,Dry Fruits,Plain Pista,3,3,0
4/8/2024,Dry Fruits,Salted Pista,3,3,0
4/8/2024,Dry Fruits,Walnut,3,3,0
4/8/2024,Groceries,Bajra flour,40,34,6
4/8/2024,Groceries,Chana Dal (Sanaga pappu),20,17,3
4/8/2024,Groceries,Idly Rawa (Sri Lalitha),33,28,5
4/8/2024,Groceries,Masoor Dal,22,19,3
4/8/2024,Groceries,Moong Dal (Pesara pappu),13,11,2
4/8/2024,Groceries,Peanuts (Palli),13,11,2
4/8/2024,Groceries,Rice Rawa,38,32,6
4/8/2024,Groceries,Toor Dal (Kandipappu),10,9,1
4/8/2024,Groceries,Urad Dal (Minapappu),10,9,1
4/8/2024,Groceries,Wheat Flour (Aashirvad),31,26,5
4/8/2024,Oils,Freedom Sunflower Oil,8,7,1
4/8/2024,Oils,Gold Drop Sunflower Oil,8,7,1
4/8/2024,Oils,Rajini Palm Oil,12,10,2
4/8/2024,Oils,Vijaya Groundnut Oil,8,7,1
4/8/2024,Seeds,Basil (Sabja) Seeds,6,5,1
4/8/2024,Seeds,Chia Seeds,6,5,1
4/8/2024,Seeds,Flax Seeds,6,5,1
4/8/2024,Seeds,Kalonji Seeds,6,5,1
4/8/2024,Seeds,Mahabeera Seeds,6,5,1
4/8/2024,Seeds,Pumpkin Seeds,6,5,1
4/8/2024,Seeds,Sunflower Seeds,6,5,1
4/8/2024,Seeds,Watermelon Seeds,6,5,1
4/8/2024,Snacks,Biscuits,322,248,74
4/8/2024,Snacks,Chips,353,272,81
4/8/2024,Snacks,Chocolates,269,207,62
4/8/2024,Snacks,Namkeen,304,234,70
4/8/2024,Snacks,Popcorn,293,226,67
4/8/2024,Spices,Cinnamon Premium,8,7,1
4/8/2024,Spices,Clove,8,7,1
4/8/2024,Spices,Coriander Seeds (Dhaniyalu),10,9,1
4/8/2024,Spices,Elachi (8 MM),8,7,1
4/8/2024,Spices,Jaji Kaya,8,7,1
4/8/2024,Spices,Khus Khus (GASALU),8,7,1
4/8/2024,Spices,Leaf Leaf (Biryani Leaf),8,7,1
4/8/2024,Spices,Mustard Seeds (aavalu),8,7,1
4/8/2024,Spices,Pepper (Miriyalu),8,7,1
4/15/2024,Cold Drinks,Coca-Cola Pocket Pack,75,63,12
4/15/2024,Cold Drinks,Mountain Dew Pocket Pack,74,62,12
4/15/2024,Cold Drinks,Sprite Pocket Pack,108,90,18
4/15/2024,Dehydrated Fruits,Blueberries,8,7,1
4/15/2024,Dehydrated Fruits,Cranberries,8,7,1
4/15/2024,Dehydrated Fruits,Dried Mango,8,7,1
4/15/2024,Dehydrated Fruits,Dry Cherries,8,7,1
4/15/2024,Dehydrated Fruits,Kiwi,8,7,1
4/15/2024,Dehydrated Fruits,Pineapple Coin,8,7,1
4/15/2024,Dehydrated Fruits,Prunes,8,7,1
4/15/2024,Dehydrated Fruits,Strawberries,8,7,1
4/15/2024,Dry Fruits,Almonds California,6,4,2
4/15/2024,Dry Fruits,Black Kismis,4,4,0
4/15/2024,Dry Fruits,Brazil Nuts,4,4,0
4/15/2024,Dry Fruits,Cashew,6,4,2
4/15/2024,Dry Fruits,Dry Dates Yellow,4,4,0
4/15/2024,Dry Fruits,Hazelnuts,4,4,0
4/15/2024,Dry Fruits,Pecan Nuts,4,4,0
4/15/2024,Dry Fruits,Plain Pista,4,4,0
4/15/2024,Dry Fruits,Salted Pista,4,4,0
4/15/2024,Dry Fruits,Walnut,4,4,0
4/15/2024,Groceries,Bajra flour,32,27,5
4/15/2024,Groceries,Chana Dal (Sanaga pappu),21,18,3
4/15/2024,Groceries,Idly Rawa (Sri Lalitha),45,38,7
4/15/2024,Groceries,Masoor Dal,27,23,4
4/15/2024,Groceries,Moong Dal (Pesara pappu),15,13,2
4/15/2024,Groceries,Peanuts (Palli),12,10,2
4/15/2024,Groceries,Rice Rawa,31,26,5
4/15/2024,Groceries,Toor Dal (Kandipappu),10,9,1
4/15/2024,Groceries,Urad Dal (Minapappu),10,9,1
4/15/2024,Groceries,Wheat Flour (Aashirvad),34,29,5
4/15/2024,Oils,Freedom Sunflower Oil,9,8,1
4/15/2024,Oils,Gold Drop Sunflower Oil,8,7,1
4/15/2024,Oils,Rajini Palm Oil,10,9,1
4/15/2024,Oils,Vijaya Groundnut Oil,8,7,1
4/15/2024,Seeds,Basil (Sabja) Seeds,4,4,0
4/15/2024,Seeds,Chia Seeds,4,4,0
4/15/2024,Seeds,Flax Seeds,4,4,0
4/15/2024,Seeds,Kalonji Seeds,4,4,0
4/15/2024,Seeds,Mahabeera Seeds,4,4,0
4/15/2024,Seeds,Pumpkin Seeds,4,4,0
4/15/2024,Seeds,Sunflower Seeds,4,4,0
4/15/2024,Seeds,Watermelon Seeds,4,4,0
4/15/2024,Snacks,Biscuits,310,239,71
4/15/2024,Snacks,Chips,330,254,76
4/15/2024,Snacks,Chocolates,322,248,74
4/15/2024,Snacks,Namkeen,339,261,78
4/15/2024,Snacks,Popcorn,276,213,63
4/15/2024,Spices,Cinnamon Premium,8,7,1
4/15/2024,Spices,Clove,8,7,1
4/15/2024,Spices,Coriander Seeds (Dhaniyalu),12,10,2
4/15/2024,Spices,Elachi (8 MM),8,7,1
4/15/2024,Spices,Jaji Kaya,8,7,1
4/15/2024,Spices,Khus Khus (GASALU),8,7,1
4/15/2024,Spices,Leaf Leaf (Biryani Leaf),8,7,1
4/15/2024,Spices,Mustard Seeds (aavalu),8,7,1
4/15/2024,Spices,Pepper (Miriyalu),8,7,1
4/22/2024,Cold Drinks,Coca-Cola Pocket Pack,75,63,12
4/22/2024,Cold Drinks,Mountain Dew Pocket Pack,81,68,13
4/22/2024,Cold Drinks,Sprite Pocket Pack,104,87,17
4/22/2024,Dehydrated Fruits,Blueberries,8,7,1
4/22/2024,Dehydrated Fruits,Cranberries,8,7,1
4/22/2024,Dehydrated Fruits,Dried Mango,8,7,1
4/22/2024,Dehydrated Fruits,Dry Cherries,8,7,1
4/22/2024,Dehydrated Fruits,Kiwi,8,7,1
4/22/2024,Dehydrated Fruits,Pineapple Coin,8,7,1
4/22/2024,Dehydrated Fruits,Prunes,8,7,1
4/22/2024,Dehydrated Fruits,Strawberries,8,7,1
4/22/2024,Dry Fruits,Almonds California,9,6,3
4/22/2024,Dry Fruits,Black Kismis,7,6,1
4/22/2024,Dry Fruits,Brazil Nuts,7,6,1
4/22/2024,Dry Fruits,Cashew,9,6,3
4/22/2024,Dry Fruits,Dry Dates Yellow,7,6,1
4/22/2024,Dry Fruits,Hazelnuts,7,6,1
4/22/2024,Dry Fruits,Pecan Nuts,7,6,1
4/22/2024,Dry Fruits,Plain Pista,7,6,1
4/22/2024,Dry Fruits,Salted Pista,7,6,1
4/22/2024,Dry Fruits,Walnut,7,6,1
4/22/2024,Groceries,Bajra flour,43,36,7
4/22/2024,Groceries,Chana Dal (Sanaga pappu),21,18,3
4/22/2024,Groceries,Idly Rawa (Sri Lalitha),38,32,6
4/22/2024,Groceries,Masoor Dal,32,27,5
4/22/2024,Groceries,Moong Dal (Pesara pappu),12,10,2
4/22/2024,Groceries,Peanuts (Palli),9,8,1
4/22/2024,Groceries,Rice Rawa,38,32,6
4/22/2024,Groceries,Toor Dal (Kandipappu),13,11,2
4/22/2024,Groceries,Urad Dal (Minapappu),13,11,2
4/22/2024,Groceries,Wheat Flour (Aashirvad),40,34,6
4/22/2024,Oils,Freedom Sunflower Oil,9,8,1
4/22/2024,Oils,Gold Drop Sunflower Oil,9,8,1
4/22/2024,Oils,Rajini Palm Oil,10,9,1
4/22/2024,Oils,Vijaya Groundnut Oil,8,7,1
4/22/2024,Seeds,Basil (Sabja) Seeds,7,6,1
4/22/2024,Seeds,Chia Seeds,7,6,1
4/22/2024,Seeds,Flax Seeds,7,6,1
4/22/2024,Seeds,Kalonji Seeds,7,6,1
4/22/2024,Seeds,Mahabeera Seeds,7,6,1
4/22/2024,Seeds,Pumpkin Seeds,7,6,1
4/22/2024,Seeds,Sunflower Seeds,7,6,1
4/22/2024,Seeds,Watermelon Seeds,7,6,1
4/22/2024,Snacks,Biscuits,301,232,69
4/22/2024,Snacks,Chips,366,282,84
4/22/2024,Snacks,Chocolates,341,263,78
4/22/2024,Snacks,Namkeen,293,226,67
4/22/2024,Snacks,Popcorn,339,261,78
4/22/2024,Spices,Cinnamon Premium,8,7,1
4/22/2024,Spices,Clove,8,7,1
4/22/2024,Spices,Coriander Seeds (Dhaniyalu),13,11,2
4/22/2024,Spices,Elachi (8 MM),8,7,1
4/22/2024,Spices,Jaji Kaya,8,7,1
4/22/2024,Spices,Khus Khus (GASALU),8,7,1
4/22/2024,Spices,Leaf Leaf (Biryani Leaf),8,7,1
4/22/2024,Spices,Mustard Seeds (aavalu),8,7,1
4/22/2024,Spices,Pepper (Miriyalu),8,7,1
4/29/2024,Cold Drinks,Coca-Cola Pocket Pack,80,67,13
4/29/2024,Cold Drinks,Mountain Dew Pocket Pack,92,77,15
4/29/2024,Cold Drinks,Sprite Pocket Pack,73,61,12
4/29/2024,Dehydrated Fruits,Blueberries,8,7,1
4/29/2024,Dehydrated Fruits,Cranberries,8,7,1
4/29/2024,Dehydrated Fruits,Dried Mango,8,7,1
4/29/2024,Dehydrated Fruits,Dry Cherries,8,7,1
4/29/2024,Dehydrated Fruits,Kiwi,8,7,1
4/29/2024,Dehydrated Fruits,Pineapple Coin,8,7,1
4/29/2024,Dehydrated Fruits,Prunes,8,7,1
4/29/2024,Dehydrated Fruits,Strawberries,8,7,1
4/29/2024,Dry Fruits,Almonds California,4,3,1
4/29/2024,Dry Fruits,Black Kismis,3,3,0
4/29/2024,Dry Fruits,Brazil Nuts,3,3,0
4/29/2024,Dry Fruits,Cashew,4,3,1
4/29/2024,Dry Fruits,Dry Dates Yellow,3,3,0
4/29/2024,Dry Fruits,Hazelnuts,3,3,0
4/29/2024,Dry Fruits,Pecan Nuts,3,3,0
4/29/2024,Dry Fruits,Plain Pista,3,3,0
4/29/2024,Dry Fruits,Salted Pista,3,3,0
4/29/2024,Dry Fruits,Walnut,3,3,0
4/29/2024,Groceries,Bajra flour,40,34,6
4/29/2024,Groceries,Chana Dal (Sanaga pappu),19,16,3
4/29/2024,Groceries,Idly Rawa (Sri Lalitha),55,46,9
4/29/2024,Groceries,Masoor Dal,21,18,3
4/29/2024,Groceries,Moong Dal (Pesara pappu),14,12,2
4/29/2024,Groceries,Peanuts (Palli),15,13,2
4/29/2024,Groceries,Rice Rawa,33,28,5
4/29/2024,Groceries,Toor Dal (Kandipappu),10,9,1
4/29/2024,Groceries,Urad Dal (Minapappu),15,13,2
4/29/2024,Groceries,Wheat Flour (Aashirvad),43,36,7
4/29/2024,Oils,Freedom Sunflower Oil,8,7,1
4/29/2024,Oils,Gold Drop Sunflower Oil,8,7,1
4/29/2024,Oils,Rajini Palm Oil,12,10,2
4/29/2024,Oils,Vijaya Groundnut Oil,8,7,1
4/29/2024,Seeds,Basil (Sabja) Seeds,3,3,0
4/29/2024,Seeds,Chia Seeds,3,3,0
4/29/2024,Seeds,Flax Seeds,3,3,0
4/29/2024,Seeds,Kalonji Seeds,3,3,0
4/29/2024,Seeds,Mahabeera Seeds,3,3,0
4/29/2024,Seeds,Pumpkin Seeds,3,3,0
4/29/2024,Seeds,Sunflower Seeds,3,3,0
4/29/2024,Seeds,Watermelon Seeds,3,3,0
4/29/2024,Snacks,Biscuits,288,222,66
4/29/2024,Snacks,Chips,287,221,66
4/29/2024,Snacks,Chocolates,326,251,75
4/29/2024,Snacks,Namkeen,306,236,70
4/29/2024,Snacks,Popcorn,322,248,74
4/29/2024,Spices,Cinnamon Premium,8,7,1
4/29/2024,Spices,Clove,8,7,1
4/29/2024,Spices,Coriander Seeds (Dhaniyalu),15,13,2
4/29/2024,Spices,Elachi (8 MM),8,7,1
4/29/2024,Spices,Jaji Kaya,8,7,1
4/29/2024,Spices,Khus Khus (GASALU),8,7,1
4/29/2024,Spices,Leaf Leaf (Biryani Leaf),9,8,1
4/29/2024,Spices,Mustard Seeds (aavalu),9,8,1
4/29/2024,Spices,Pepper (Miriyalu),8,7,1
5/6/2024,Cold Drinks,Coca-Cola Pocket Pack,74,62,12
5/6/2024,Cold Drinks,Mountain Dew Pocket Pack,91,76,15
5/6/2024,Cold Drinks,Sprite Pocket Pack,94,79,15
5/6/2024,Dehydrated Fruits,Blueberries,8,7,1
5/6/2024,Dehydrated Fruits,Cranberries,8,7,1
5/6/2024,Dehydrated Fruits,Dried Mango,8,7,1
5/6/2024,Dehydrated Fruits,Dry Cherries,8,7,1
5/6/2024,Dehydrated Fruits,Kiwi,8,7,1
5/6/2024,Dehydrated Fruits,Pineapple Coin,8,7,1
5/6/2024,Dehydrated Fruits,Prunes,8,7,1
5/6/2024,Dehydrated Fruits,Strawberries,8,7,1
5/6/2024,Dry Fruits,Almonds California,9,6,3
5/6/2024,Dry Fruits,Black Kismis,7,6,1
5/6/2024,Dry Fruits,Brazil Nuts,7,6,1
5/6/2024,Dry Fruits,Cashew,9,6,3
5/6/2024,Dry Fruits,Dry Dates Yellow,7,6,1
5/6/2024,Dry Fruits,Hazelnuts,7,6,1
5/6/2024,Dry Fruits,Pecan Nuts,7,6,1
5/6/2024,Dry Fruits,Plain Pista,7,6,1
5/6/2024,Dry Fruits,Salted Pista,7,6,1
5/6/2024,Dry Fruits,Walnut,7,6,1
5/6/2024,Groceries,Bajra flour,42,35,7
5/6/2024,Groceries,Chana Dal (Sanaga pappu),18,15,3
5/6/2024,Groceries,Idly Rawa (Sri Lalitha),44,37,7
5/6/2024,Groceries,Masoor Dal,25,21,4
5/6/2024,Groceries,Moong Dal (Pesara pappu),13,11,2
5/6/2024,Groceries,Peanuts (Palli),12,10,2
5/6/2024,Groceries,Rice Rawa,32,27,5
5/6/2024,Groceries,Toor Dal (Kandipappu),14,12,2
5/6/2024,Groceries,Urad Dal (Minapappu),10,9,1
5/6/2024,Groceries,Wheat Flour (Aashirvad),36,30,6
5/6/2024,Oils,Freedom Sunflower Oil,8,7,1
5/6/2024,Oils,Gold Drop Sunflower Oil,8,7,1
5/6/2024,Oils,Rajini Palm Oil,8,7,1
5/6/2024,Oils,Vijaya Groundnut Oil,8,7,1
5/6/2024,Seeds,Basil (Sabja) Seeds,6,5,1
5/6/2024,Seeds,Chia Seeds,6,5,1
5/6/2024,Seeds,Flax Seeds,6,5,1
5/6/2024,Seeds,Kalonji Seeds,6,5,1
5/6/2024,Seeds,Mahabeera Seeds,6,5,1
5/6/2024,Seeds,Pumpkin Seeds,6,5,1
5/6/2024,Seeds,Sunflower Seeds,6,5,1
5/6/2024,Seeds,Watermelon Seeds,6,5,1
5/6/2024,Snacks,Biscuits,310,239,71
5/6/2024,Snacks,Chips,319,246,73
5/6/2024,Snacks,Chocolates,297,229,68
5/6/2024,Snacks,Namkeen,309,238,71
5/6/2024,Snacks,Popcorn,323,249,74
5/6/2024,Spices,Cinnamon Premium,8,7,1
5/6/2024,Spices,Clove,8,7,1
5/6/2024,Spices,Coriander Seeds (Dhaniyalu),9,8,1
5/6/2024,Spices,Elachi (8 MM),8,7,1
5/6/2024,Spices,Jaji Kaya,8,7,1
5/6/2024,Spices,Khus Khus (GASALU),8,7,1
5/6/2024,Spices,Leaf Leaf (Biryani Leaf),9,8,1
5/6/2024,Spices,Mustard Seeds (aavalu),8,7,1
5/6/2024,Spices,Pepper (Miriyalu),8,7,1
5/13/2024,Cold Drinks,Coca-Cola Pocket Pack,102,85,17
5/13/2024,Cold Drinks,Mountain Dew Pocket Pack,70,59,11
5/13/2024,Cold Drinks,Sprite Pocket Pack,88,74,14
5/13/2024,Dehydrated Fruits,Blueberries,8,7,1
5/13/2024,Dehydrated Fruits,Cranberries,8,7,1
5/13/2024,Dehydrated Fruits,Dried Mango,8,7,1
5/13/2024,Dehydrated Fruits,Dry Cherries,8,7,1
5/13/2024,Dehydrated Fruits,Kiwi,8,7,1
5/13/2024,Dehydrated Fruits,Pineapple Coin,8,7,1
5/13/2024,Dehydrated Fruits,Prunes,8,7,1
5/13/2024,Dehydrated Fruits,Strawberries,8,7,1
5/13/2024,Dry Fruits,Almonds California,4,3,1
5/13/2024,Dry Fruits,Black Kismis,3,3,0
5/13/2024,Dry Fruits,Brazil Nuts,3,3,0
5/13/2024,Dry Fruits,Cashew,4,3,1
5/13/2024,Dry Fruits,Dry Dates Yellow,3,3,0
5/13/2024,Dry Fruits,Hazelnuts,3,3,0
5/13/2024,Dry Fruits,Pecan Nuts,3,3,0
5/13/2024,Dry Fruits,Plain Pista,3,3,0
5/13/2024,Dry Fruits,Salted Pista,3,3,0
5/13/2024,Dry Fruits,Walnut,3,3,0
5/13/2024,Groceries,Bajra flour,42,35,7
5/13/2024,Groceries,Chana Dal (Sanaga pappu),16,14,2
5/13/2024,Groceries,Idly Rawa (Sri Lalitha),44,37,7
5/13/2024,Groceries,Masoor Dal,30,25,5
5/13/2024,Groceries,Moong Dal (Pesara pappu),14,12,2
5/13/2024,Groceries,Peanuts (Palli),9,8,1
5/13/2024,Groceries,Rice Rawa,32,27,5
5/13/2024,Groceries,Toor Dal (Kandipappu),13,11,2
5/13/2024,Groceries,Urad Dal (Minapappu),10,9,1
5/13/2024,Groceries,Wheat Flour (Aashirvad),44,37,7
5/13/2024,Oils,Freedom Sunflower Oil,8,7,1
5/13/2024,Oils,Gold Drop Sunflower Oil,8,7,1
5/13/2024,Oils,Rajini Palm Oil,9,8,1
5/13/2024,Oils,Vijaya Groundnut Oil,8,7,1
5/13/2024,Seeds,Basil (Sabja) Seeds,7,6,1
5/13/2024,Seeds,Chia Seeds,7,6,1
5/13/2024,Seeds,Flax Seeds,7,6,1
5/13/2024,Seeds,Kalonji Seeds,7,6,1
5/13/2024,Seeds,Mahabeera Seeds,7,6,1
5/13/2024,Seeds,Pumpkin Seeds,7,6,1
5/13/2024,Seeds,Sunflower Seeds,7,6,1
5/13/2024,Seeds,Watermelon Seeds,7,6,1
5/13/2024,Snacks,Biscuits,312,240,72
5/13/2024,Snacks,Chips,291,224,67
5/13/2024,Snacks,Chocolates,317,244,73
5/13/2024,Snacks,Namkeen,299,230,69
5/13/2024,Snacks,Popcorn,310,239,71
5/13/2024,Spices,Cinnamon Premium,8,7,1
5/13/2024,Spices,Clove,8,7,1
5/13/2024,Spices,Coriander Seeds (Dhaniyalu),10,9,1
5/13/2024,Spices,Elachi (8 MM),8,7,1
5/13/2024,Spices,Jaji Kaya,8,7,1
5/13/2024,Spices,Khus Khus (GASALU),8,7,1
5/13/2024,Spices,Leaf Leaf (Biryani Leaf),8,7,1
5/13/2024,Spices,Mustard Seeds (aavalu),8,7,1
5/13/2024,Spices,Pepper (Miriyalu),8,7,1
5/20/2024,Cold Drinks,Coca-Cola Pocket Pack,93,78,15
5/20/2024,Cold Drinks,Mountain Dew Pocket Pack,66,55,11
5/20/2024,Cold Drinks,Sprite Pocket Pack,96,80,16
5/20/2024,Dehydrated Fruits,Blueberries,8,7,1
5/20/2024,Dehydrated Fruits,Cranberries,8,7,1
5/20/2024,Dehydrated Fruits,Dried Mango,8,7,1
5/20/2024,Dehydrated Fruits,Dry Cherries,8,7,1
5/20/2024,Dehydrated Fruits,Kiwi,8,7,1
5/20/2024,Dehydrated Fruits,Pineapple Coin,8,7,1
5/20/2024,Dehydrated Fruits,Prunes,8,7,1
5/20/2024,Dehydrated Fruits,Strawberries,8,7,1
5/20/2024,Dry Fruits,Almonds California,7,5,2
5/20/2024,Dry Fruits,Black Kismis,6,5,1
5/20/2024,Dry Fruits,Brazil Nuts,6,5,1
5/20/2024,Dry Fruits,Cashew,7,5,2
5/20/2024,Dry Fruits,Dry Dates Yellow,6,5,1
5/20/2024,Dry Fruits,Hazelnuts,6,5,1
5/20/2024,Dry Fruits,Pecan Nuts,6,5,1
5/20/2024,Dry Fruits,Plain Pista,6,5,1
5/20/2024,Dry Fruits,Salted Pista,6,5,1
5/20/2024,Dry Fruits,Walnut,6,5,1
5/20/2024,Groceries,Bajra flour,56,47,9
5/20/2024,Groceries,Chana Dal (Sanaga pappu),22,19,3
5/20/2024,Groceries,Idly Rawa (Sri Lalitha),48,40,8
5/20/2024,Groceries,Masoor Dal,22,19,3
5/20/2024,Groceries,Moong Dal (Pesara pappu),19,16,3
5/20/2024,Groceries,Peanuts (Palli),14,12,2
5/20/2024,Groceries,Rice Rawa,21,18,3
5/20/2024,Groceries,Toor Dal (Kandipappu),9,8,1
5/20/2024,Groceries,Urad Dal (Minapappu),12,10,2
5/20/2024,Groceries,Wheat Flour (Aashirvad),45,38,7
5/20/2024,Oils,Freedom Sunflower Oil,8,7,1
5/20/2024,Oils,Gold Drop Sunflower Oil,8,7,1
5/20/2024,Oils,Rajini Palm Oil,10,9,1
5/20/2024,Oils,Vijaya Groundnut Oil,8,7,1
5/20/2024,Seeds,Basil (Sabja) Seeds,7,6,1
5/20/2024,Seeds,Chia Seeds,7,6,1
5/20/2024,Seeds,Flax Seeds,7,6,1
5/20/2024,Seeds,Kalonji Seeds,7,6,1
5/20/2024,Seeds,Mahabeera Seeds,7,6,1
5/20/2024,Seeds,Pumpkin Seeds,7,6,1
5/20/2024,Seeds,Sunflower Seeds,7,6,1
5/20/2024,Seeds,Watermelon Seeds,7,6,1
5/20/2024,Snacks,Biscuits,339,261,78
5/20/2024,Snacks,Chips,296,228,68
5/20/2024,Snacks,Chocolates,262,202,60
5/20/2024,Snacks,Namkeen,328,253,75
5/20/2024,Snacks,Popcorn,305,235,70
5/20/2024,Spices,Cinnamon Premium,8,7,1
5/20/2024,Spices,Clove,8,7,1
5/20/2024,Spices,Coriander Seeds (Dhaniyalu),13,11,2
5/20/2024,Spices,Elachi (8 MM),8,7,1
5/20/2024,Spices,Jaji Kaya,8,7,1
5/20/2024,Spices,Khus Khus (GASALU),8,7,1
5/20/2024,Spices,Leaf Leaf (Biryani Leaf),8,7,1
5/20/2024,Spices,Mustard Seeds (aavalu),8,7,1
5/20/2024,Spices,Pepper (Miriyalu),8,7,1
5/27/2024,Cold Drinks,Coca-Cola Pocket Pack,92,77,15
5/27/2024,Cold Drinks,Mountain Dew Pocket Pack,69,58,11
5/27/2024,Cold Drinks,Sprite Pocket Pack,94,79,15
5/27/2024,Dehydrated Fruits,Blueberries,8,7,1
5/27/2024,Dehydrated Fruits,Cranberries,8,7,1
5/27/2024,Dehydrated Fruits,Dried Mango,8,7,1
5/27/2024,Dehydrated Fruits,Dry Cherries,8,7,1
5/27/2024,Dehydrated Fruits,Kiwi,8,7,1
5/27/2024,Dehydrated Fruits,Pineapple Coin,8,7,1
5/27/2024,Dehydrated Fruits,Prunes,8,7,1
5/27/2024,Dehydrated Fruits,Strawberries,8,7,1
5/27/2024,Dry Fruits,Almonds California,6,4,2
5/27/2024,Dry Fruits,Black Kismis,4,4,0
5/27/2024,Dry Fruits,Brazil Nuts,4,4,0
5/27/2024,Dry Fruits,Cashew,6,4,2
5/27/2024,Dry Fruits,Dry Dates Yellow,4,4,0
5/27/2024,Dry Fruits,Hazelnuts,4,4,0
5/27/2024,Dry Fruits,Pecan Nuts,4,4,0
5/27/2024,Dry Fruits,Plain Pista,4,4,0
5/27/2024,Dry Fruits,Salted Pista,4,4,0
5/27/2024,Dry Fruits,Walnut,4,4,0
5/27/2024,Groceries,Bajra flour,40,34,6
5/27/2024,Groceries,Chana Dal (Sanaga pappu),19,16,3
5/27/2024,Groceries,Idly Rawa (Sri Lalitha),50,42,8
5/27/2024,Groceries,Masoor Dal,32,27,5
5/27/2024,Groceries,Moong Dal (Pesara pappu),14,12,2
5/27/2024,Groceries,Peanuts (Palli),12,10,2
5/27/2024,Groceries,Rice Rawa,22,19,3
5/27/2024,Groceries,Toor Dal (Kandipappu),13,11,2
5/27/2024,Groceries,Urad Dal (Minapappu),10,9,1
5/27/2024,Groceries,Wheat Flour (Aashirvad),28,24,4
5/27/2024,Oils,Freedom Sunflower Oil,8,7,1
5/27/2024,Oils,Gold Drop Sunflower Oil,8,7,1
5/27/2024,Oils,Rajini Palm Oil,9,8,1
5/27/2024,Oils,Vijaya Groundnut Oil,8,7,1
5/27/2024,Seeds,Basil (Sabja) Seeds,4,4,0
5/27/2024,Seeds,Chia Seeds,4,4,0
5/27/2024,Seeds,Flax Seeds,4,4,0
5/27/2024,Seeds,Kalonji Seeds,4,4,0
5/27/2024,Seeds,Mahabeera Seeds,4,4,0
5/27/2024,Seeds,Pumpkin Seeds,4,4,0
5/27/2024,Seeds,Sunflower Seeds,4,4,0
5/27/2024,Seeds,Watermelon Seeds,4,4,0
5/27/2024,Snacks,Biscuits,325,250,75
5/27/2024,Snacks,Chips,331,255,76
5/27/2024,Snacks,Chocolates,305,235,70
5/27/2024,Snacks,Namkeen,261,201,60
5/27/2024,Snacks,Popcorn,315,243,72
5/27/2024,Spices,Cinnamon Premium,8,7,1
5/27/2024,Spices,Clove,8,7,1
5/27/2024,Spices,Coriander Seeds (Dhaniyalu),13,11,2
5/27/2024,Spices,Elachi (8 MM),8,7,1
5/27/2024,Spices,Jaji Kaya,8,7,1
5/27/2024,Spices,Khus Khus (GASALU),8,7,1
5/27/2024,Spices,Leaf Leaf (Biryani Leaf),8,7,1
5/27/2024,Spices,Mustard Seeds (aavalu),8,7,1
5/27/2024,Spices,Pepper (Miriyalu),8,7,1
6/3/2024,Cold Drinks,Coca-Cola Pocket Pack,64,54,10
6/3/2024,Cold Drinks,Mountain Dew Pocket Pack,100,84,16
6/3/2024,Cold Drinks,Sprite Pocket Pack,86,72,14
6/3/2024,Dehydrated Fruits,Blueberries,8,7,1
6/3/2024,Dehydrated Fruits,Cranberries,8,7,1
6/3/2024,Dehydrated Fruits,Dried Mango,8,7,1
6/3/2024,Dehydrated Fruits,Dry Cherries,8,7,1
6/3/2024,Dehydrated Fruits,Kiwi,8,7,1
6/3/2024,Dehydrated Fruits,Pineapple Coin,8,7,1
6/3/2024,Dehydrated Fruits,Prunes,8,7,1
6/3/2024,Dehydrated Fruits,Strawberries,8,7,1
6/3/2024,Dry Fruits,Almonds California,7,5,2
6/3/2024,Dry Fruits,Black Kismis,6,5,1
6/3/2024,Dry Fruits,Brazil Nuts,6,5,1
6/3/2024,Dry Fruits,Cashew,7,5,2
6/3/2024,Dry Fruits,Dry Dates Yellow,6,5,1
6/3/2024,Dry Fruits,Hazelnuts,6,5,1
6/3/2024,Dry Fruits,Pecan Nuts,6,5,1
6/3/2024,Dry Fruits,Plain Pista,6,5,1
6/3/2024,Dry Fruits,Salted Pista,6,5,1
6/3/2024,Dry Fruits,Walnut,6,5,1
6/3/2024,Groceries,Bajra flour,46,39,7
6/3/2024,Groceries,Chana Dal (Sanaga pappu),19,16,3
6/3/2024,Groceries,Idly Rawa (Sri Lalitha),51,43,8
6/3/2024,Groceries,Masoor Dal,19,16,3
6/3/2024,Groceries,Moong Dal (Pesara pappu),10,9,1
6/3/2024,Groceries,Peanuts (Palli),12,10,2
6/3/2024,Groceries,Rice Rawa,39,33,6
6/3/2024,Groceries,Toor Dal (Kandipappu),12,10,2
6/3/2024,Groceries,Urad Dal (Minapappu),10,9,1
6/3/2024,Groceries,Wheat Flour (Aashirvad),28,24,4
6/3/2024,Oils,Freedom Sunflower Oil,8,7,1
6/3/2024,Oils,Gold Drop Sunflower Oil,8,7,1
6/3/2024,Oils,Rajini Palm Oil,10,9,1
6/3/2024,Oils,Vijaya Groundnut Oil,8,7,1
6/3/2024,Seeds,Basil (Sabja) Seeds,6,5,1
6/3/2024,Seeds,Chia Seeds,6,5,1
6/3/2024,Seeds,Flax Seeds,6,5,1
6/3/2024,Seeds,Kalonji Seeds,6,5,1
6/3/2024,Seeds,Mahabeera Seeds,6,5,1
6/3/2024,Seeds,Pumpkin Seeds,6,5,1
6/3/2024,Seeds,Sunflower Seeds,6,5,1
6/3/2024,Seeds,Watermelon Seeds,6,5,1
6/3/2024,Snacks,Biscuits,289,223,66
6/3/2024,Snacks,Chips,384,296,88
6/3/2024,Snacks,Chocolates,284,219,65
6/3/2024,Snacks,Namkeen,304,234,70
6/3/2024,Snacks,Popcorn,305,235,70
6/3/2024,Spices,Cinnamon Premium,8,7,1
6/3/2024,Spices,Clove,8,7,1
6/3/2024,Spices,Coriander Seeds (Dhaniyalu),12,10,2
6/3/2024,Spices,Elachi (8 MM),8,7,1
6/3/2024,Spices,Jaji Kaya,8,7,1
6/3/2024,Spices,Khus Khus (GASALU),8,7,1
6/3/2024,Spices,Leaf Leaf (Biryani Leaf),8,7,1
6/3/2024,Spices,Mustard Seeds (aavalu),8,7,1
6/3/2024,Spices,Pepper (Miriyalu),8,7,1
6/10/2024,Cold Drinks,Coca-Cola Pocket Pack,87,73,14
6/10/2024,Cold Drinks,Mountain Dew Pocket Pack,87,73,14
6/10/2024,Cold Drinks,Sprite Pocket Pack,79,66,13
6/10/2024,Dehydrated Fruits,Blueberries,8,7,1
6/10/2024,Dehydrated Fruits,Cranberries,8,7,1
6/10/2024,Dehydrated Fruits,Dried Mango,8,7,1
6/10/2024,Dehydrated Fruits,Dry Cherries,8,7,1
6/10/2024,Dehydrated Fruits,Kiwi,8,7,1
6/10/2024,Dehydrated Fruits,Pineapple Coin,8,7,1
6/10/2024,Dehydrated Fruits,Prunes,8,7,1
6/10/2024,Dehydrated Fruits,Strawberries,8,7,1
6/10/2024,Dry Fruits,Almonds California,6,4,2
6/10/2024,Dry Fruits,Black Kismis,4,4,0
6/10/2024,Dry Fruits,Brazil Nuts,4,4,0
6/10/2024,Dry Fruits,Cashew,6,4,2
6/10/2024,Dry Fruits,Dry Dates Yellow,4,4,0
6/10/2024,Dry Fruits,Hazelnuts,4,4,0
6/10/2024,Dry Fruits,Pecan Nuts,4,4,0
6/10/2024,Dry Fruits,Plain Pista,4,4,0
6/10/2024,Dry Fruits,Salted Pista,4,4,0
6/10/2024,Dry Fruits,Walnut,4,4,0
6/10/2024,Groceries,Bajra flour,46,39,7
6/10/2024,Groceries,Chana Dal (Sanaga pappu),24,20,4
6/10/2024,Groceries,Idly Rawa (Sri Lalitha),52,44,8
6/10/2024,Groceries,Masoor Dal,15,13,2
6/10/2024,Groceries,Moong Dal (Pesara pappu),12,10,2
6/10/2024,Groceries,Peanuts (Palli),12,10,2
6/10/2024,Groceries,Rice Rawa,34,29,5
6/10/2024,Groceries,Toor Dal (Kandipappu),13,11,2
6/10/2024,Groceries,Urad Dal (Minapappu),10,9,1
6/10/2024,Groceries,Wheat Flour (Aashirvad),43,36,7
6/10/2024,Oils,Freedom Sunflower Oil,8,7,1
6/10/2024,Oils,Gold Drop Sunflower Oil,8,7,1
6/10/2024,Oils,Rajini Palm Oil,9,8,1
6/10/2024,Oils,Vijaya Groundnut Oil,8,7,1
6/10/2024,Seeds,Basil (Sabja) Seeds,4,4,0
6/10/2024,Seeds,Chia Seeds,4,4,0
6/10/2024,Seeds,Flax Seeds,4,4,0
6/10/2024,Seeds,Kalonji Seeds,4,4,0
6/10/2024,Seeds,Mahabeera Seeds,4,4,0
6/10/2024,Seeds,Pumpkin Seeds,4,4,0
6/10/2024,Seeds,Sunflower Seeds,4,4,0
6/10/2024,Seeds,Watermelon Seeds,4,4,0
6/10/2024,Snacks,Biscuits,306,236,70
6/10/2024,Snacks,Chips,269,207,62
6/10/2024,Snacks,Chocolates,331,255,76
6/10/2024,Snacks,Namkeen,356,274,82
6/10/2024,Snacks,Popcorn,280,216,64
6/10/2024,Spices,Cinnamon Premium,8,7,1
6/10/2024,Spices,Clove,8,7,1
6/10/2024,Spices,Coriander Seeds (Dhaniyalu),10,9,1
6/10/2024,Spices,Elachi (8 MM),8,7,1
6/10/2024,Spices,Jaji Kaya,8,7,1
6/10/2024,Spices,Khus Khus (GASALU),8,7,1
6/10/2024,Spices,Leaf Leaf (Biryani Leaf),9,8,1
6/10/2024,Spices,Mustard Seeds (aavalu),9,8,1
6/10/2024,Spices,Pepper (Miriyalu),8,7,1
6/17/2024,Cold Drinks,Coca-Cola Pocket Pack,81,68,13
6/17/2024,Cold Drinks,Mountain Dew Pocket Pack,80,67,13
6/17/2024,Cold Drinks,Sprite Pocket Pack,88,74,14
6/17/2024,Dehydrated Fruits,Blueberries,8,7,1
6/17/2024,Dehydrated Fruits,Cranberries,8,7,1
6/17/2024,Dehydrated Fruits,Dried Mango,8,7,1
6/17/2024,Dehydrated Fruits,Dry Cherries,8,7,1
6/17/2024,Dehydrated Fruits,Kiwi,8,7,1
6/17/2024,Dehydrated Fruits,Pineapple Coin,8,7,1
6/17/2024,Dehydrated Fruits,Prunes,8,7,1
6/17/2024,Dehydrated Fruits,Strawberries,8,7,1
6/17/2024,Dry Fruits,Almonds California,4,3,1
6/17/2024,Dry Fruits,Black Kismis,3,3,0
6/17/2024,Dry Fruits,Brazil Nuts,3,3,0
6/17/2024,Dry Fruits,Cashew,4,3,1
6/17/2024,Dry Fruits,Dry Dates Yellow,3,3,0
6/17/2024,Dry Fruits,Hazelnuts,3,3,0
6/17/2024,Dry Fruits,Pecan Nuts,3,3,0
6/17/2024,Dry Fruits,Plain Pista,3,3,0
6/17/2024,Dry Fruits,Salted Pista,3,3,0
6/17/2024,Dry Fruits,Walnut,3,3,0
6/17/2024,Groceries,Bajra flour,37,31,6
6/17/2024,Groceries,Chana Dal (Sanaga pappu),22,19,3
6/17/2024,Groceries,Idly Rawa (Sri Lalitha),46,39,7
6/17/2024,Groceries,Masoor Dal,27,23,4
6/17/2024,Groceries,Moong Dal (Pesara pappu),8,7,1
6/17/2024,Groceries,Peanuts (Palli),9,8,1
6/17/2024,Groceries,Rice Rawa,40,34,6
6/17/2024,Groceries,Toor Dal (Kandipappu),13,11,2
6/17/2024,Groceries,Urad Dal (Minapappu),13,11,2
6/17/2024,Groceries,Wheat Flour (Aashirvad),27,23,4
6/17/2024,Oils,Freedom Sunflower Oil,8,7,1
6/17/2024,Oils,Gold Drop Sunflower Oil,9,8,1
6/17/2024,Oils,Rajini Palm Oil,10,9,1
6/17/2024,Oils,Vijaya Groundnut Oil,8,7,1
6/17/2024,Seeds,Basil (Sabja) Seeds,7,6,1
6/17/2024,Seeds,Chia Seeds,7,6,1
6/17/2024,Seeds,Flax Seeds,7,6,1
6/17/2024,Seeds,Kalonji Seeds,7,6,1
6/17/2024,Seeds,Mahabeera Seeds,7,6,1
6/17/2024,Seeds,Pumpkin Seeds,7,6,1
6/17/2024,Seeds,Sunflower Seeds,7,6,1
6/17/2024,Seeds,Watermelon Seeds,7,6,1
6/17/2024,Snacks,Biscuits,343,264,79
6/17/2024,Snacks,Chips,331,255,76
6/17/2024,Snacks,Chocolates,299,230,69
6/17/2024,Snacks,Namkeen,248,191,57
6/17/2024,Snacks,Popcorn,331,255,76
6/17/2024,Spices,Cinnamon Premium,8,7,1
6/17/2024,Spices,Clove,8,7,1
6/17/2024,Spices,Coriander Seeds (Dhaniyalu),14,12,2
6/17/2024,Spices,Elachi (8 MM),8,7,1
6/17/2024,Spices,Jaji Kaya,8,7,1
6/17/2024,Spices,Khus Khus (GASALU),8,7,1
6/17/2024,Spices,Leaf Leaf (Biryani Leaf),9,8,1
6/17/2024,Spices,Mustard Seeds (aavalu),8,7,1
6/17/2024,Spices,Pepper (Miriyalu),8,7,1
6/24/2024,Cold Drinks,Coca-Cola Pocket Pack,90,75,15
6/24/2024,Cold Drinks,Mountain Dew Pocket Pack,72,60,12
6/24/2024,Cold Drinks,Sprite Pocket Pack,81,68,13
6/24/2024,Dehydrated Fruits,Blueberries,8,7,1
6/24/2024,Dehydrated Fruits,Cranberries,8,7,1
6/24/2024,Dehydrated Fruits,Dried Mango,8,7,1
6/24/2024,Dehydrated Fruits,Dry Cherries,8,7,1
6/24/2024,Dehydrated Fruits,Kiwi,8,7,1
6/24/2024,Dehydrated Fruits,Pineapple Coin,8,7,1
6/24/2024,Dehydrated Fruits,Prunes,8,7,1
6/24/2024,Dehydrated Fruits,Strawberries,8,7,1
6/24/2024,Dry Fruits,Almonds California,6,4,2
6/24/2024,Dry Fruits,Black Kismis,4,4,0
6/24/2024,Dry Fruits,Brazil Nuts,4,4,0
6/24/2024,Dry Fruits,Cashew,6,4,2
6/24/2024,Dry Fruits,Dry Dates Yellow,4,4,0
6/24/2024,Dry Fruits,Hazelnuts,4,4,0
6/24/2024,Dry Fruits,Pecan Nuts,4,4,0
6/24/2024,Dry Fruits,Plain Pista,4,4,0
6/24/2024,Dry Fruits,Salted Pista,4,4,0
6/24/2024,Dry Fruits,Walnut,4,4,0
6/24/2024,Groceries,Bajra flour,52,44,8
6/24/2024,Groceries,Chana Dal (Sanaga pappu),22,19,3
6/24/2024,Groceries,Idly Rawa (Sri Lalitha),44,37,7
6/24/2024,Groceries,Masoor Dal,21,18,3
6/24/2024,Groceries,Moong Dal (Pesara pappu),15,13,2
6/24/2024,Groceries,Peanuts (Palli),10,9,1
6/24/2024,Groceries,Rice Rawa,25,21,4
6/24/2024,Groceries,Toor Dal (Kandipappu),13,11,2
6/24/2024,Groceries,Urad Dal (Minapappu),10,9,1
6/24/2024,Groceries,Wheat Flour (Aashirvad),28,24,4
6/24/2024,Oils,Freedom Sunflower Oil,8,7,1
6/24/2024,Oils,Gold Drop Sunflower Oil,9,8,1
6/24/2024,Oils,Rajini Palm Oil,10,9,1
6/24/2024,Oils,Vijaya Groundnut Oil,8,7,1
6/24/2024,Seeds,Basil (Sabja) Seeds,7,6,1
6/24/2024,Seeds,Chia Seeds,7,6,1
6/24/2024,Seeds,Flax Seeds,7,6,1
6/24/2024,Seeds,Kalonji Seeds,7,6,1
6/24/2024,Seeds,Mahabeera Seeds,7,6,1
6/24/2024,Seeds,Pumpkin Seeds,7,6,1
6/24/2024,Seeds,Sunflower Seeds,7,6,1
6/24/2024,Seeds,Watermelon Seeds,7,6,1
6/24/2024,Snacks,Biscuits,267,206,61
6/24/2024,Snacks,Chips,283,218,65
6/24/2024,Snacks,Chocolates,313,241,72
6/24/2024,Snacks,Namkeen,347,267,80
6/24/2024,Snacks,Popcorn,339,261,78
6/24/2024,Spices,Cinnamon Premium,8,7,1
6/24/2024,Spices,Clove,8,7,1
6/24/2024,Spices,Coriander Seeds (Dhaniyalu),10,9,1
6/24/2024,Spices,Elachi (8 MM),8,7,1
6/24/2024,Spices,Jaji Kaya,8,7,1
6/24/2024,Spices,Khus Khus (GASALU),8,7,1
6/24/2024,Spices,Leaf Leaf (Biryani Leaf),8,7,1
6/24/2024,Spices,Mustard Seeds (aavalu),8,7,1
6/24/2024,Spices,Pepper (Miriyalu),8,7,1
